
ACROSS

SYSTEMSTHINKER | Always looking at the whole picture
ITALIA | Boot-shaped country that makes up half my heritage
SOUTH | With 21-across, where I was born and raised
DELIVEROO | Currently here, doing IC stuff and leading a small team
JA | Joburg affirmative that still lingers in my lexicon
RUSK| Like a biscotti, but Afrikaans
OPINION | I'll offer a strong one of these, loosely held
AFRICA | See 12-across
PRODUCTDESIGNER | Automator or layouts and drawer of rectangles (for 13+ years)
CROSSWORDS | My favourite word puzzles (in case you haven't noticed)
UIKIT | Usually creating and maintaining this to make rest of my work easy and consistent
SKI | Despite living in 1-down for 5 years, I still hate this snowy activity
VIPPS| Before 10-across, I was at one of Scandinavia's leading fintechs
NORWEGIAN | Jeg snakker litt av dette språket fordi jeg bodd i 1-ned for fem år
AUTOLAYOUT | It definitely fills my container, if you know what I mean
KAYAK | Once paddled one of these (unknowingly) across a shipping lane in Ha long bay

DOWN
OSLONORWAY | My first ever international flight was a one-way ticket here
BEKIND | If you can be anything in this world...
HTML | What 7-down assures me this website is written in
UNO | The cause of more family feuds in my house than Monopoly
DASH | 10-across was acquired by Door-this in 2024
CURSOR | The tool I fought with to create what you see here
SCORPIO | Being born in November makes me one of these, I guess
VHS | Folks my age fondly remember renting movies in this format
ABOUTME | This puzzle replaces this part of my site
HADEDA | A large Ibis known locally as a "flying vuvuzela"
BLACKCAT | Furry, panther-like animal that insists on sleeping on my keyboard
ANDROID | Might be rare to meet a 22-across that prefers this
NEGRONI | The Sbagliato version is indeed a mistake
APPS | Makes up most of my portfolio, with some tooling and web in-between
GRIDS | This puzzle's construction relies on these
SISTER | I'm a big one of these by 4 years
FIGMA | One of the tools of my trade
LONDON | Currently living here
PASTA | The noodle of my people over at 8-across
IDEAS | Mind set?
COLD | My unusual personal preference when it comes to toast
BAKE | I'd rather cook than do this
SEW | Taught myself to do this
